########
#  @   #
#     $#
#$    .#
#.     #
########